 {
	"Title":"Level1",
	"GridXSize":100,
	"GridYSize":100,
 	"Grid": [
 		"TTTTTTTTTTTTTTTTTTTTTTTTTTTTTTTTTTTTTTTTTTTTTTTTTTTTTTTTTTTTTTTTTTTTTTTTTTTTTTTTTTTTTTTTTTTTTTTTTTTT",
 		"R....R........T....................................................................................T",
 		"R....R........T....................................................................................T",
		"R....R........T....................................................................................T",
		"R....R........T....................................................................................T",
		"R....R........T....................................................................................T",
		"R....R........T....................................................................................T",
		"R....R........T....................................................................................T",
		"R....R........T....................................................................................T",
		"R....R........T....................................................................................T",
		"R....R........T....................................................................................T",
		"R....R........T....................................................................................T",
		"R....R........T.................................C..................................................T",
		"R....R........T....................................................................................T",
		"R....R........T..................................................C.................................T",
		"R....R........T....................................................................................T",
		"R....R........T..................R.................................................................T",
 		"R....R........T............................................................................C.......T",
		"R....R........T....................................................................................T",
		"R....R........T......................................................M.............................T",
		"R....R........T....................................................................................T",
		"R....R........T.....................M..............................................................T",
		"R....R........T....................................................................................T",
		"R....R........T......................................C.............................................T",
		"R....R........T....................................................................................T",
		"R....R........T....................................................................................T",
		"R....R........T....................................................................................T",
		"R....R........T....................................................................................T",
		"R....R........T....................................................................................T",
		"R....R........T...........................................................M........................T",
		"R....R........T....................................................................................T",
		"R....R........T...............................................................C....................T",
 		"R....R........T............C.......................................................................T",
		"R....R........T....................................................................................T",
		"R....R........T....................................................................................T",
		"R....R........T....................................................................................T",
		"R....R........T....................................................................................T",
		"R....R........T.....................M..............................................................T",
		"R....R........T....................................................................................T",
		"R....R........T....................................................................................T",
		"R....R........T.......................................M............................................T",
		"R....R........T....................................................................................T",
		"R....R........T....................................................................................T",
		"R....R........T....................................................................................T",
		"R....R........T....................................................................................T",
		"R....R........T............................C.......................................................T",
		"R....R........T....................................................................................T",
 		"R....R........T....................................................................................T",
		"R....R........T..................R.................................................................T",
		"R....R........T....................................................................................T",
		"R....R........T....................................................................................T",
		"R....R........T....................................................................................T",
		"R....R........T....................................................................................T",
		"R....R........T...........................................................M........................T",
		"R....R........T........................R...........................................................T",
		"R....R........T....................................................................................T",
		"R....R........T....................................................................................T",
		"R....R........T....................................................................................T",
		"R....R........T....................................................................................T",
		"R....R........T....................................................................................T",
		"R....R........T..............................M............................M........................T",
		"R....R........T....................................................................................T",
 		"R....R........T....................................................................................T",
		"R....R........T....................................................................................T",
		"R....R........T....................................................................................T",
		"R....R........T....................................................................................T",
		"R....R........T..............................................................................C.....T",
		"R....R.............................................................................................T",
		"R....R........T....................................................................................T",
		"R.............T..................................S.................................................T",
		"R....R........T....................................................................................T",
		"R....R........T....................................................................................T",
		"R....R........T....................................................................................T",
		"R....R........T....................................................................................T",
		"R.............T....................................................................................T",
		"R....R........T....................................................................................T",
		"R....R.............................................................................................T",
 		"R....R........T....................................................................................T",
		"R....R........T....................................................................................T",
		"R....R.............................................................................................T",
		"R.............T....................................................................................T",
		"R....R.............................................................................................T",
		"R....R........T........................................................C...........................T",
		"R....R........T....................................................................................T",
		"R....R........T....................................................................................T",
		"R.............T....................................................................................T",
		"R....R........T...................C................................................................T",
		"R....R........T....................................................................................T",
		"R....R........T....................................................................................T",
		"R....R........T....................................................................................T",
		"R....R........T....................................................................................T"
 	]
 }