 {
	"Title":"Level1",
	"GridXSize":20,
	"GridYSize":20,
 	"Grid": [
 		"R...R.....R...R.....",
 		".....R....R...T.....",
 		"..........R...R.....",
 		".....T....R.........",
 		"..R.......R...R.....",
 		"....T...S.....R.....",
 		"..........R...R.....",
 		".R...T....R...R.....",
 		"....R..R..R...R.....",
 		".........R...R.....T"
 	]
 }