 {
	"Title":"Level1",
	"GridXSize":10,
	"GridYSize":10,
 	"Grid": [
 		"R...T.....",
 		".....R....",
 		".....T....",
 		"..........",
 		"..T...T...",
 		"..........",
 		"..........",
 		".S........",
 		"....T..T..",
 		"T........E"
 	]
 }