 {
	"Title":"Process Sim",
	"GridXSize":10,
	"GridYSize":10,	
 	"Grid": [
 		"R...R.....",
 		".....R....",
 		"..........",
 		"..........",
 		"..R.......",
 		"..........",
 		"..........",
 		".R........",
 		".......R.E",
 		"S..R......"
 	]
 }