 {
	"Title":"Level1",
	"GridXSize":100,
	"GridYSize":100,
 	"Grid": [
 		"TTTTTTTTTTTTTTTTTTTTTTTTTTTTTTTTTTTTTTTTTTTTTTTTTTTTTTTTTTTTTTTTTTTTTTTTTTTTTTTTTTTTTTTTTTTTTTTTTTTT",
 		"R....R........T.....TTTTTTTTTTTTTT.................................................................T",
 		"R....R........T.....T...TT...TT..T.................................................................T",
		"R....R........T.....T...RR...RR..T............C...................................M................T",
		"R....R........T.......R....R...R....................................M..............................T",
		"R....R........T.......RRRRRRRRRR...................................................................T",
		"R....R........T..........TTTT...............C......................................................T",
		"R....R........T...........TT.........................................M.................M...........T",
		"R....R........T.....C..............C...............................................................T",
		"R....R........T....................................................................................T",
		"R....R........T..............C............................................M........................T",
		"R....R........T........................C...........................................................T",
		"R....R........T.................................C..................................................T",
		"R....R........T....................................................................................T",
		"R....R........T..................................................C.................................T",
		"R....R........T....................................................................................T",
		"R....R........T..................R.................................................................T",
 		"R....R........T............................................................................C.......T",
		"R....R........T....................................................................................T",
		"R....R........T......................................................M..................C..........T",
		"R....R........T....................................................................................T",
		"R....R........T.....................M..............................................................T",
		"R....R........T....................................................................................T",
		"R....R........T......................................C.............................................T",
		"R....R........T..............................................................R....T................T",
		"R....R........T..............................................................R....T................T",
		"R....R........T..............................................................R....T................T",
		"R....R........T....................................................................................T",
		"R....R........T....................................................................................T",
		"R....R........T...........................................................M........................T",
		"R....R........T....................................................................................T",
		"R....R........T...............................................................C....................T",
 		"R....R........T............C.......................................................................T",
		"R....R........T..............................C......................................C..............T",
		"R....R........T....................................................................................T",
		"R....R........T.....................................................................C..............T",
		"R....R........T.........................................................C..........................T",
		"R....R........T.....................M..............................................................T",
		"R....R........T...........................M........................................................T",
		"R....R........T.............M......................................................................T",
		"R....R........T.......................................M............................................T",
		"R....R........T....................................................................................T",
		"R....R........T..............................................RR....................................T",
		"R....R........T.....C..............................................................................T",
		"R....R........T..................................M...................M.............................T",
		"R....R........T............................C.......................................................T",
		"R....R........T....................................................................................T",
 		"R....R........T...............................C...................................................T",
		"R....R........T...........RR.....R.........................................M.......................T",
		"R....R........T................................................RRR.................................T",
		"R....R........T....................................................................................T",
		"R....R........T..............M....CT........CRR....................................................T",
		"R....R........T....................................................................................T",
		"R....R........T...........................................................M........................T",
		"R....R........T........................R...........................................................T",
		"R....R........T...............................C............RRRR....................................T",
		"R....R........T....................................................................................T",
		"R....R........T...........CCC......................................................................T",
		"R....R........T....................................................................................T",
		"R....R........T....................................................................................T",
		"R....R........T..............................M............................M........................T",
		"R....R........T....................................................................................T",
 		"R....R........T............................................M.....................M.................T",
		"R....R........T............CC......................................................................T",
		"R....R........T........................RRRRRR........................R.............................T",
		"R....R........T............................................TTTT.................T..................T",
		"R....R........T...............R.........RRR................TTTT..............................C.....T",
		"R....R..................R..................................TTTT.................T..................T",
		"R....R........T............................................TTTT.................T..................T",
		"R.............T.....................R......TTT...S......................RR......T..................T",
		"R....R........T..........................................................R......T..................T",
		"R....R........T..........................................................R......T..................T",
		"R....R........T............R............................TTTTT............R......T..................T",
		"R....R........T...........................TTTTT.................................T..................T",
		"R.............T....................................................................................T",
		"R....R........T..............................................TTTRCCCC..............................T",
		"R....R.............................................................................................T",
 		"R....R........T....................................................................................T",
		"R....R........T.............R......................................................................T",
		"R....R......................................................................TTTTT..................T",
		"R.............T.............................R...............C......................................T",
		"R....R.............................................................................................T",
		"R....R........T........................................................C...........................T",
		"R....R........T....................................................................................T",
		"R....R........T......RR..................................................TTTT......................T",
		"R.............T...............................RRTT.................................................T",
		"R....R........T...................C................................................................T",
		"R....R........T.....................................................................RRRR...........T",
		"R....R........T....................................T................TTTT...........................T",
		"R....R........T..............C.....................................................................T",
		"R....R........T....................................................................................T"
 	]
 }